12  17
/////////////////
/0--/----/-----1/
///-////-/-/-////
///---//---/---//
/////-//////--///
/////------/-////
//////////-/---//
//////////-///-//
//////////-----//
//////////////-//
//////////////-//
//////////////-//