6 24
////////////////////////
///------------//-----0/
////-////////-----//////
/----//---/--/////----1/
////----/-----------////
////////////////////////